%%%%%%%%%%%%%%%%%%%%%%%%%%%%%%%%%%%%%%%%%%%%%%%%%%%%%%%%%%%%
%%%%%%%%%%%%%%%%%%%%%%%%%%%%%%%%%%%%%%%%%%%%%%%%%%%%%%%%%%%%
%%%%%%%%CC%%%%%%CC%%%%%%CC%%%%%%CC%%%%%%CC%%%%%%CC%%%%%%%%%%
%%%%%%%%SN%%%%%%SN%%%%%%SN%%%%%%SN%%%%%%SN%%%%%%SN%%%%%%%%%%
%%%%%%%%SN%%%%%%SN%%%%%%SN%%%%%%SN%%%%%%SN%%%%%%SN%%%%%%%%%%
%%%%%%%%SN%%%%%%SN%%%%%%SN%%%%%%SN%%%%%%SN%%%%%%SN%%%%%%%%%%
%%%%%%%%SN%%%%%%SN%%%%%%SN%%%%%%SN%%%%%%SN%%%%%%SN%%%%%%%%%%
%%%%%%%%SN%%%%%%SN%%%%%%SN%%%%%%SN%%%%%%SN%%%%%%SN%%%%%%%%%%
%%CWWWWWIIWWWWWWIIWWWWWWIIWWWWWWIIWWWWWWIIWWWWWWIIWWWWWWWC%%
%%CEEEEEIIEEEEEEIIEEEEEEIIEEEEEEIIEEEEEEIIEEEEEEIIEEEEEEEC%%
%%%%%%%%SN%%%%%%SN%%%%%%SN%%%%%%SN%%%%%%SN%%%%%%SN%%%%%%%%%%
%%%%%%%%SN%%%%%%SN%%%%%%SN%%%%%%SN%%%%%%SN%%%%%%SN%%%%%%%%%%
%%%%%%%%SN%%%%%%SN%%%%%%SN%%%%%%SN%%%%%%SN%%%%%%SN%%%%%%%%%%
%%%%%%%%SN%%%%%%SN%%%%%%SN%%%%%%SN%%%%%%SN%%%%%%SN%%%%%%%%%%
%%%%%%%%SN%%%%%%SN%%%%%%SN%%%%%%SN%%%%%%SN%%%%%%SN%%%%%%%%%%
%%%%%%%%SN%%%%%%SN%%%%%%SN%%%%%%SN%%%%%%SN%%%%%%SN%%%%%%%%%%
%%CWWWWWIIWWWWWWIIWWWWWWIIWWWWWWIIWWWWWWIIWWWWWWIIWWWWWWWC%%
%%CEEEEEIIEEEEEEIIEEEEEEIIEEEEEEIIEEEEEEIIEEEEEEIIEEEEEEEC%%
%%%%%%%%SN%%%%%%SN%%%%%%SN%%%%%%SN%%%%%%SN%%%%%%SN%%%%%%%%%%
%%%%%%%%SN%%%%%%SN%%%%%%SN%%%%%%SN%%%%%%SN%%%%%%SN%%%%%%%%%%
%%%%%%%%SN%%%%%%SN%%%%%%SN%%%%%%SN%%%%%%SN%%%%%%SN%%%%%%%%%%
%%%%%%%%SN%%%%%%SN%%%%%%SN%%%%%%SN%%%%%%SN%%%%%%SN%%%%%%%%%%
%%%%%%%%SN%%%%%%SN%%%%%%SN%%%%%%SN%%%%%%SN%%%%%%SN%%%%%%%%%%
%%%%%%%%SN%%%%%%SN%%%%%%SN%%%%%%SN%%%%%%SN%%%%%%SN%%%%%%%%%%
%%CWWWWWIIWWWWWWIIWWWWWWIIWWWWWWIIWWWWWWIIWWWWWWIIWWWWWWWC%%
%%CEEEEEIIEEEEEEIIEEEEEEIIEEEEEEIIEEEEEEIIEEEEEEIIEEEEEEEC%%
%%%%%%%%SN%%%%%%SN%%%%%%SN%%%%%%SN%%%%%%SN%%%%%%SN%%%%%%%%%%
%%%%%%%%SN%%%%%%SN%%%%%%SN%%%%%%SN%%%%%%SN%%%%%%SN%%%%%%%%%%
%%%%%%%%SN%%%%%%SN%%%%%%SN%%%%%%SN%%%%%%SN%%%%%%SN%%%%%%%%%%
%%%%%%%%SN%%%%%%SN%%%%%%SN%%%%%%SN%%%%%%SN%%%%%%SN%%%%%%%%%%
%%%%%%%%SN%%%%%%SN%%%%%%SN%%%%%%SN%%%%%%SN%%%%%%SN%%%%%%%%%%
%%%%%%%%SN%%%%%%SN%%%%%%SN%%%%%%SN%%%%%%SN%%%%%%SN%%%%%%%%%%
%%CWWWWWIIWWWWWWIIWWWWWWIIWWWWWWIIWWWWWWIIWWWWWWIIWWWWWWWC%%
%%CEEEEEIIEEEEEEIIEEEEEEIIEEEEEEIIEEEEEEIIEEEEEEIIEEEEEEEC%%
%%%%%%%%SN%%%%%%SN%%%%%%SN%%%%%%SN%%%%%%SN%%%%%%SN%%%%%%%%%%
%%%%%%%%SN%%%%%%SN%%%%%%SN%%%%%%SN%%%%%%SN%%%%%%SN%%%%%%%%%%
%%%%%%%%SN%%%%%%SN%%%%%%SN%%%%%%SN%%%%%%SN%%%%%%SN%%%%%%%%%%
%%%%%%%%CC%%%%%%CC%%%%%%CC%%%%%%CC%%%%%%CC%%%%%%CC%%%%%%%%%%
%%%%%%%%%%%%%%%%%%%%%%%%%%%%%%%%%%%%%%%%%%%%%%%%%%%%%%%%%%%%
%%%%%%%%%%%%%%%%%%%%%%%%%%%%%%%%%%%%%%%%%%%%%%%%%%%%%%%%%%%%
