%%%%%%%%%%%
%%%%CC%%%%%
%%%%SN%%%%%
%CWWIIWWWW%
%CEEIIEESN%
%%%%SN%%SN%
%%%%CC%%CC%
%%%%%%%%%%%
