%%%%%%%%%%%
%%%%CC%%%%%
%%%%NS%%%%%
%CEEIIEES%%
%%%%NS%%S%%
%%%%NS%%C%%
%%%%CC%%%%%
%%%%%%%%%%%
